#, #, #, #, #, #, #, ., #, ., ., #
#, ., #, ., ., #, #, #, #, ., ., #
#, ., #, ., ., ., ., #, #, ., ., #
#, ., #, ., ., #, #, #, #, #, #, #
#, ., ., #, ., ., ., ., #, ., ., #
#, ., ., ., #, ., #, #, ., ., ., #
#, ., ., ., ., #, ., ., #, ., ., #
#, ., ., ., ., #, ., ., #, ., ., #
#, ., ., ., ., ., ., #, ., ., ., #
#, #, #, #, #, #, #, #, #, #, #, #
